кс=x
дж=g
ий=y,i
eй=y,i
ый=y,i
а=a
б=b
в=v,w,ff
г=g,gu
д=d
е=e,ye,je,ie,eu
ё=e,o,yo,jo,ye,io
ж=zh,j,g
з=z,s
и=i,yi,y
й=,j,y,i,jj
к=k,c
л=l
м=m
н=n,ne
о=o
п=p
р=r
с=s,ss
т=t
у=y,u,ou
ф=f,ph
х=ch,h,kh,x
ц=c,ts,z,tc
ч=ch,tsch,tch,c
ш=sh
щ=sch,shh,shch,sc,schtsch,stsch,chtch
ъ=,',j
ы=y,ui
ь=,',j
э=e,eh
ю=ju,yu,iu,iou,ou,you,eu,u,y
я=ja,ya,ia,a